15
17
#E###############
# ##            #
# ## ########## #
# ## #          #
# ## # # ###### #
# ## # # #    # #
# #  # # #### # #
# ## # #      # #
# ## # # ########
# ## # # #      #
# ## # # # ## # #
# ## # # #  # # #
# ## # ###### # #
#    #        # #
###############S#