13
41
#########################################
#             #             ## ##       #
# ########### # ########### ## ## ##### #
E               #         # ## ## ## ## #
######################### #    ## ## ## #
S  ###            #    ## # ##### ## ## #
## # # ############ ## #  # ## ## ##    #
## # # #             # ## #       ## ## #
## # # # ############# ## ############# #
##       #                              #
#########################################
